00000000000000000000
00000000000000000000
00000000000000000000
00000110000110000000
00001521001221000000
00012222112222100000
00123222222223210000
00122214224122210000
00012221111222100000
00001221441221000000
00000122322210000000
00000012322100000000
00000001221000000000
00000000110000000000
00000000000000000000
00000000000000000000
00000000000000000000
00000000000000000000
00000000000000000000
00000000000000000000