00000000000000000000
00000000000000000000
00000000000000000000
00000000000000000000
00000000000000000000
00000111111111000000
00000122522221000000
00000123312121000000
00000123212141000000
00000111211141000000
00000111222241000000
00000122221221000000
00000012222111000000
00000011111111000000
00000000000000000000
00000000000000000000
00000000000000000000
00000000000000000000
00000000000000000000
00000000000000000000