00000000000000000000
00000000000000000000
00000000000000000000
00000110000110000000
00001221001221000000
00012222112222100000
00122232322322210000
00122211111122210000
00012224442222100000
00001222222221000000
00000122222210000000
00000012252100000000
00000001221000000000
00000000110000000000
00000000000000000000
00000000000000000000
00000000000000000000
00000000000000000000
00000000000000000000
00000000000000000000